; starter-authored-v1:1
; Single push to solve.
#####
#@$.#
#####

; starter-authored-v1:2
; One walk then one push.
######
#@ $.#
######

; starter-authored-v1:3
; Two-box starter puzzle (optimal unknown).
#######
#@ $ .#
#     #
#  $ .#
#######
